,name,iou,acc,precision,recall,pos,neg,tp,tn,fp,fn
0,m_3807525_sw_18_1_20170611,0.011425788813916544,0.0117913590943646,0.011464678019585142,0.7710813334793712,693884,46150928,535041,17323,46133605,158843
1,m_3807543_se_18_1_20170611,0.00854440021567885,0.008957204578952287,0.008566234496200194,0.7702322614318439,517305,46134415,398445,19424,46114991,118860
2,m_3907624_ne_18_1_20170709,0.01093876870799428,0.011989703008559933,0.01097077509320022,0.7894499006315486,639539,45565025,504884,49095,45515930,134655
3,m_3807635_ne_18_1_20170626,0.004360740614120273,0.0045941605975800635,0.004365244272220693,0.8086753909741276,256219,47269329,207198,11142,47258187,49021
4,m_3907557_se_18_1_20170709,0.013861208186601347,0.014023018897926143,0.013883540823428275,0.896018591403562,719042,45769022,644275,7628,45761394,74767
5,m_3807551_nw_18_1_20170611,0.006426372353012864,0.007131880489975504,0.006440205131459304,0.7494966530860717,400817,46378991,300411,33217,46345774,100406
6,m_3807608_nw_18_1_20170611,0.006429211867089803,0.007108768403066345,0.006443557318060326,0.7427860536553876,404321,46340063,300324,31971,46308092,103997
7,m_3807639_se_18_1_20170709,0.0011527648829933984,0.0012314608917115234,0.0011530127541775873,0.842823434443789,64418,47037362,54293,3711,47033651,10125
8,m_3807634_ne_18_1_20170626,0.013143091343226023,0.015291763063476039,0.013214568068452531,0.7084450980125176,881316,46727452,624364,103658,46623794,256952
9,m_3807539_ne_18_1_20170611,0.014092638852435377,0.014372378098587095,0.014125514909918932,0.8582573208541592,756674,45338690,649421,13079,45325611,107253
10,m_3907631_nw_18_1_20170611,0.005205346483754865,0.005465005086899149,0.005212676579203525,0.7873108083465756,307096,46153428,241780,12127,46141301,65316
11,m_3807518_ne_18_1_20170611,0.014220174609051959,0.015960318036112836,0.01430742817095625,0.6998580866782441,944943,45643477,661326,82240,45561237,283617
12,m_3807622_nw_18_1_20170730,0.0021989073870872827,0.002671609514458212,0.002199912874064255,0.8279127805595994,125018,46967942,103504,22310,46945632,21514
13,m_3807605_sw_18_1_20170611,0.0039108890861621285,0.005213894369340423,0.003914253342520838,0.8198279663772713,224491,46896525,184044,61640,46834885,40447
14,m_3807536_sw_18_1_20170611,0.027595413316113364,0.03349516277129408,0.027974936374895894,0.6704107050519845,1904895,44655649,1277062,282491,44373158,627833
15,m_3807548_sw_18_1_20170611,0.0051237793958329005,0.0055979389145715125,0.0051300230372216,0.8080577389235151,292489,45857175,236348,21995,45835180,56141
16,m_3807646_sw_18_1_20170730,0.0003648460824609629,0.00044038564596375146,0.0003649001405026178,0.7112136442283925,24274,47297886,17264,3576,47294310,7010
17,m_3807613_ne_18_1_20170730,0.0002375695023544444,0.00030358464353589837,0.00023758321811556213,0.804502625332662,13903,47070165,11185,3109,47067056,2718
18,m_3807543_nw_18_1_20170611,0.00845942477042695,0.008666191461034567,0.008467067634239643,0.9035836626538005,437011,46251549,394876,9736,46241813,42135
19,m_3807511_nw_18_1_20170611,0.016057523655497993,0.01612750118410466,0.016083022436132886,0.9101371823696291,818837,45595979,745254,3301,45592678,73583
20,m_3907620_sw_18_1_20170611,0.004503431305866185,0.004665296584468859,0.0045079714834423525,0.8172342901474011,257800,46532580,210683,7608,46524972,47117
21,m_3807562_nw_18_1_20170611,0.001961783452641662,0.0019785692102412865,0.001961989800483751,0.9491170931188413,96103,46399617,91213,782,46398835,4890
22,m_3807606_ne_18_1_20170611,0.011764759449880554,0.014497608165492778,0.011823509150332737,0.7030600486971096,782798,46126802,550354,129723,45997079,232444
23,m_3907646_nw_18_1_20170611,0.006134842451518898,0.009546862747783687,0.006161287023441895,0.5883671069352078,485537,46240703,285674,160415,46080288,199863
24,m_3807653_sw_18_1_20170730,0.00251632245018345,0.0028722474654794693,0.002518185206994508,0.7728157726217197,154597,47342355,119475,16948,47325407,35122
25,m_3807635_sw_18_1_20170716,0.004833456201427935,0.005360609205430395,0.0048416062412309,0.7416927879468029,310092,47298676,229993,25219,47273457,80099
26,m_3907558_sw_18_1_20170609,0.032801848292558826,0.03288594653510834,0.03284017501578453,0.9656430554929937,1576217,44829563,1522063,4035,44825528,54154
27,m_3907719_nw_18_1_20170628,0.02053490015344418,0.024196834710993934,0.020742584996391755,0.6722310058118212,1455998,46386458,978767,178869,46207589,477231
28,m_3907517_ne_18_1_20170609,0.010697338838060198,0.010920866304802757,0.010711464602783513,0.890251167022279,553974,45559126,493176,10419,45548707,60798
29,m_3807740_sw_18_1_20170731,0.0007300283146205097,0.0007859592015553061,0.0007302488997852154,0.7073254452206922,49526,47938970,35031,2686,47936284,14495
30,m_3807533_nw_18_1_20170611,0.005213741895678741,0.00658098394591907,0.005222355854141308,0.7596684136608091,321123,46532509,243947,64396,46468113,77176
31,m_3907637_nw_18_1_20170611,0.007245299623718257,0.007873757113967352,0.007265265319176168,0.725008297200364,467025,46295911,338597,29603,46266308,128428
32,m_3907642_nw_18_1_20170609,0.006832918796442037,0.008471654288384001,0.0068612638036358135,0.6232093296534237,517404,46751404,322451,77994,46673410,194953
33,m_3807617_se_18_1_20170716,0.01705041958899284,0.019947832427627654,0.01718403198334324,0.686802408859964,1179147,46458109,809841,140419,46317690,369306
34,m_3807647_sw_18_1_20170730,0.00026803400669010675,0.0003022457298467319,0.0002680421572738047,0.8981113320079522,14084,47179304,12649,1615,47177689,1435
35,m_3807552_nw_18_1_20170611,0.0029517382300078476,0.0029710372950879412,0.0029563572910251117,0.6538850557246579,210589,46441131,137701,903,46440228,72888
36,m_3807633_ne_18_1_20170626,0.002841630352964471,0.0029020706915708584,0.002842682872536482,0.8847232732301751,153292,47576076,135621,2893,47573183,17671
37,m_3807652_nw_18_1_20170626,0.0026202418286339455,0.0027658771436786904,0.0026218178217115966,0.8133989698115668,153370,47464074,124751,6953,47457121,28619
38,m_3907717_se_18_1_20170628,0.006817271888304506,0.007651068652526284,0.006852990708362407,0.5667164703662216,577601,47478431,327336,40344,47438087,250265
39,m_3807626_ne_18_1_20170626,0.0035265722674164782,0.0038502382315307427,0.003529660520096954,0.801217727355341,209078,47307722,167517,15434,47292288,41561
40,m_3907647_sw_18_1_20170611,0.0006295160749319934,0.0009693262161224636,0.0006296853130861535,0.7007998090008356,41885,46601855,29353,15860,46585995,12532
41,m_3807619_sw_18_1_20170626,0.002217052578337589,0.002399979810753622,0.0022189826239021413,0.7182269910175554,146508,47324308,105226,8703,47315605,41282
42,m_3907645_sw_18_1_20170611,0.043490924442878005,0.05453590521906592,0.044222764086632484,0.7243675272122398,2782847,44108609,2015804,541464,43567145,767043
43,m_3907534_sw_18_1_20170609,0.021900298155268377,0.022053672049665768,0.021935512618752134,0.9317031279082839,1085262,45092218,1011142,7241,45084977,74120
44,m_3807612_ne_18_1_20170730,0.003917265481311011,0.005310203793641171,0.003921719580524132,0.7752329812354518,238002,46928926,184507,65959,46862967,53495
45,m_3907644_se_18_1_20170611,0.06416133128836668,0.10054779807849473,0.0676921172166528,0.5515894205061067,5247510,41689858,2894471,1824978,39864880,2353039
46,m_3807551_sw_18_1_20170611,0.00921022915969076,0.009837449525231056,0.009238684783597788,0.7493912870949383,574573,46205235,430580,29614,46175621,143993
47,m_3907641_se_18_1_20170609,0.013160007695353056,0.015195179027996645,0.013216373651467892,0.7552429941334916,821954,46446854,620775,97483,46349371,201179
48,m_3807601_se_18_1_20170716,0.04103962836572865,0.0531806631739961,0.042096915524103336,0.6203539888613379,3102527,44396561,1924665,601368,43795193,1177862
49,m_3807632_ne_18_1_20170611,0.010827093879502855,0.01167386476009339,0.010854857020456249,0.8089118393538398,626470,46218342,506759,40101,46178241,119711
50,m_3807561_ne_18_1_20170611,0.005099058186664341,0.0051834083185982064,0.005106784795954827,0.7711746349256863,307951,46270089,237484,3949,46266140,70467
51,m_3807605_ne_18_1_20170611,0.0014578636023173234,0.07808676635558885,0.001477076934081399,0.10078186369408687,627603,46364713,63251,3606227,42758486,564352
52,m_3907619_nw_18_1_20170609,0.008476465208082587,0.010460390724992602,0.00852901657698332,0.5790747831568626,685288,46224432,396833,93861,46130571,288455
53,m_3907657_sw_18_1_20170716,0.02894323702980279,0.03757058136980583,0.02943467723975857,0.6341749760188439,2146477,45306555,1361242,421596,44884959,785235
54,m_3807614_nw_18_1_20170730,0.001893641356694826,0.0020682202697458454,0.0018944178199088778,0.8220676403477168,108249,46893031,88988,8221,46884810,19261
55,m_3807526_nw_18_1_20170611,0.005588323400126595,0.00583032381928434,0.005593717023653862,0.8528468232193253,305797,46373943,260798,11360,46362583,44999
56,m_3807630_se_18_1_20170730,0.0005280093045728368,0.000597278674892021,0.000528052334722038,0.8663023425806676,28729,47110071,24888,3267,47106804,3841
57,m_3807664_nw_18_1_20170611,0.004618962997015998,0.029918818804194666,0.004631946494623209,0.6223343652706712,341429,46860635,212483,1199747,45660888,128946
58,m_3907641_sw_18_1_20170609,0.009985247629439663,0.010994333315143266,0.01002115326450729,0.7359284292004376,641826,46710022,472338,48264,46661758,169488
59,m_3807561_sw_18_1_20170611,0.008138258566979997,0.008225970580193412,0.008162464894393817,0.7329239221564984,517654,46105902,379401,4123,46101779,138253
60,m_3807510_nw_18_1_20170611,0.014442343178215303,0.014873938374651322,0.014484522650116108,0.8322015931562471,806575,45690525,671233,20362,45670163,135342
61,m_3807502_nw_18_1_20170609,0.03991899479061525,0.04004366710698312,0.039974863571963525,0.966173449659869,1918966,44532474,1854054,6032,44526442,64912
62,m_3807544_se_18_1_20170611,0.008101067170951654,0.008173066153612575,0.00811142864871465,0.8637950679766258,437062,46169070,377532,3383,46165687,59530
63,m_3807662_sw_18_1_20170730,0.0006050130192008189,0.0006650276613748765,0.0006050361589813005,0.9405444360729845,30527,47429153,28712,2850,47426303,1815
64,m_3807545_se_18_1_20170611,0.0053149300751645255,0.005392634672460566,0.005319522211581866,0.8602728457800921,286902,46154590,246814,3628,46150962,40088
65,m_3907533_nw_18_1_20170709,0.004695542319632698,0.005153206663863258,0.004701035679581077,0.800728923676753,271359,46024669,217285,21288,46003381,54074
66,m_3907627_ne_18_1_20170611,0.007154303110145121,0.007810352682648363,0.007166334015455778,0.8099414004495771,414167,46504841,335451,31003,46473838,78716
67,m_3907541_nw_18_1_20170709,0.011635471858374843,0.011758816363687004,0.0116505846589118,0.8996979184379783,599838,45787654,539673,5789,45781865,60165
68,m_3807648_nw_18_1_20170611,0.0015869156669071735,0.001748223495324249,0.001587638273118848,0.7771147076589806,96018,46931722,74617,7598,46924124,21401
69,m_3907518_nw_18_1_20170709,0.007790371577959245,0.008206082019584693,0.0078011581210098435,0.8492667247353771,422488,45654312,358805,19305,45635007,63683
70,m_3807627_nw_18_1_20170716,0.0021550055958109884,0.0024178185399690213,0.0021560406288936235,0.8178179697548271,125177,47391623,102372,12515,47379108,22805
71,m_3807618_se_18_1_20170626,0.005429521214143729,0.005685778503602936,0.005433881514344935,0.8712396046560332,296046,47220754,257927,12243,47208511,38119
72,m_3807542_sw_18_1_20170611,0.003955341834738262,0.012513883928647714,0.003962057737206963,0.7000114390299702,262260,46554460,183585,402274,46152186,78675
73,m_3807560_nw_18_1_20170611,0.01250990882807066,0.013826058188606884,0.01257732951270144,0.7000351234294853,834201,45908695,583970,62300,45846395,250231
74,m_3807654_sw_18_1_20170730,0.0011844116567824722,0.0013001056231682563,0.001184690109891501,0.8344131720510001,67294,47346546,56151,5492,47341054,11143
75,m_3807636_nw_18_1_20170626,0.0041801645523286,0.004503954281234766,0.004185464278858479,0.7675115582092327,258258,47175394,198216,15423,47159971,60042
76,m_3907663_nw_18_1_20170611,0.0025857401442764146,0.002815813513955364,0.0025871497621621775,0.8259583797184792,146419,46634733,120936,10791,46623942,25483
77,m_3807510_ne_18_1_20170611,0.028380617295877892,0.028624623901275563,0.028470741669634515,0.8996546045341253,1466435,45030665,1319285,11677,45018988,147150
78,m_3807644_sw_18_1_20170626,0.009128201137270697,0.009708208461638456,0.009148491564910247,0.8045232511794749,539435,47032061,433988,27846,47004215,105447
79,m_3907663_se_18_1_20170611,0.003915616986730854,0.004154726983771853,0.003919417160520876,0.8015275542908754,228077,46470539,182810,11210,46459329,45267
80,m_3907629_sw_18_1_20170611,0.008915392236421243,0.009326849763234245,0.008931665895093858,0.8303112011679018,501412,46215648,416328,19395,46196253,85084
81,m_3907559_sw_18_1_20170609,0.033166719661166834,0.03332202303587668,0.033227391264961964,0.9478190316062256,1620725,44702843,1536154,7441,44695402,84571
82,m_3907637_ne_18_1_20170611,0.009246814946664987,0.010620638370650894,0.009276320156680217,0.7440597338264007,579772,46137288,431385,64780,46072508,148387
83,m_3907632_nw_18_1_20170611,0.012127768656203346,0.01571693966825822,0.012221662023125248,0.612194938110984,915429,45462811,560421,168503,45294308,355008
84,m_3807547_sw_18_1_20170611,0.00431288166622237,0.004431756154334516,0.004314540379859603,0.9181561791187607,217353,46059787,199564,5525,46054262,17789
85,m_3807611_sw_18_1_20170716,0.004995030943192392,0.0056565935752814055,0.005003144149921995,0.7549181242725258,313585,47111247,236731,31532,47079715,76854
86,m_3907631_ne_18_1_20170611,0.004031413043881177,0.004328993043586173,0.004035481325762219,0.7999563802445272,233839,46180881,187061,13868,46167013,46778
87,m_3807527_nw_18_1_20170611,0.008993669639493595,0.009728694221675277,0.009022287745978639,0.7392702801943283,566464,46030848,418770,34561,45996287,147694
88,m_3907659_nw_18_1_20170716,0.03740075143472138,0.046632604089473666,0.03832326527272679,0.60841284874479,2876172,44364724,1749900,453066,43911658,1126272
89,m_3807630_sw_18_1_20170730,0.00015522373697423686,0.00016351710268398855,0.00015522375343891576,0.999317126468178,7322,47131478,7317,391,47131087,5
90,m_3907633_nw_18_1_20170609,0.008747239721894938,0.009664215069303617,0.008779668695417754,0.7031043520113746,587981,46717775,413412,43761,46674014,174569
91,m_3807661_ne_18_1_20170730,0.0007944116678913653,0.0009568192923200629,0.0007945953195921939,0.7746293786702805,48702,47448250,37726,7720,47440530,10976
92,m_3807644_nw_18_1_20170626,0.012248976983179583,0.012918083553713048,0.012292531505020056,0.7756372479740594,750022,46775526,581745,32194,46743332,168277
93,m_3807739_sw_18_1_20170731,0.00048194842333036046,0.0005046731100673682,0.0004820026568136095,0.8107257726192141,28604,48089672,23190,1094,48088578,5414
94,m_3807648_ne_18_1_20170611,0.0010684063555270059,0.0012023329209526123,0.001068667014139087,0.8141377801546016,61707,46966033,50238,6305,46959728,11469
95,m_3907635_nw_18_1_20170609,0.0051455901945189906,0.0058392637348439,0.00515400312660612,0.7591716997411562,318725,46738235,241967,32811,46705424,76758
96,m_3807616_nw_18_1_20170611,0.008566177894201691,0.009015786056860854,0.008581418194750261,0.8282787978275387,483691,46306461,400631,21219,46285242,83060
97,m_3907661_nw_18_1_20170611,0.008525613564079363,0.012872090169016725,0.008547898186405356,0.7658211578010374,521264,46507928,399195,206169,46301759,122069
98,m_3807534_ne_18_1_20170611,0.006775884247326009,0.007618538421337799,0.006786113356346048,0.8180230916490298,386027,46256909,315779,39572,46217337,70248
99,m_3807620_sw_18_1_20170626,0.00823679599605185,0.00883292119540306,0.008253648767820313,0.8013497369000055,486317,46855439,389710,28456,46826983,96607
100,m_3907517_nw_18_1_20170709,0.01710408795723728,0.017454725901103623,0.01715353668729609,0.8557691474426746,923152,45281412,790005,16483,45264929,133147
101,m_3907650_nw_18_1_20170716,0.027925777264939326,0.036163550480689914,0.028554945469510717,0.5589696992728731,2341957,44935923,1309083,400653,44535270,1032874
102,m_3807630_ne_18_1_20170730,0.0009018078781537365,0.0010226395241287431,0.0009019489120263795,0.8522305764411028,49875,47088925,42505,5701,47083224,7370
103,m_3907635_se_18_1_20170611,0.027364941261346868,0.03155169550191853,0.027595585516358653,0.7660324302601095,1672142,45338834,1280915,202361,45136473,391227
104,m_3807557_nw_18_1_20170611,0.004986803897491654,0.05758870800018487,0.005129895040811567,0.15166500936410052,1466238,45615874,222377,2489021,43126853,1243861
105,m_3807628_nw_18_1_20170626,0.00809413552749228,0.008911584543395478,0.008114411385668718,0.764110786881654,502045,46931607,383618,39091,46892516,118427
106,m_3807653_se_18_1_20170730,0.0033241584953507494,0.0038795537534280574,0.0033271422476300336,0.7875380288444727,200177,47250899,157647,26442,47224457,42530
107,m_3907628_sw_18_1_20170611,0.006584559878934216,0.006990530920469817,0.006593733366648205,0.8255669915536519,373771,46508505,308573,19159,46489346,65198
108,m_3807560_sw_18_1_20170611,0.009406934603149848,0.009843099058820227,0.009442126164177889,0.7162268946583791,613765,46137771,439595,20585,46117186,174170
109,m_3807625_ne_18_1_20170626,0.02212491357455635,0.02426598231931334,0.022278132364449726,0.7628634601712377,1381238,46348130,1053696,104504,46243626,327542
110,m_3807535_se_18_1_20170611,0.017260022718719483,0.017860775316545254,0.017312635360200123,0.8502894657301744,946226,45696710,804566,28513,45668197,141660
111,m_3807740_ne_18_1_20170716,0.00106163694893253,0.0011925906950078981,0.0010618610765551907,0.8341562638408163,60961,47843991,50851,6280,47837711,10110
112,m_3807503_nw_18_1_20170609,0.03953729453799526,0.03959094219282493,0.03957921897664226,0.9739077863322149,1882324,44486868,1833210,2590,44484278,49114
113,m_3907633_sw_18_1_20170609,0.022243118059263114,0.02825867747712191,0.022631360770404972,0.5645720232023376,1850848,45417960,1044937,290817,45127143,805911
114,m_3807643_ne_18_1_20170626,0.008434881003901063,0.009324260056904664,0.00846439849501348,0.7074976396156324,566645,47004851,400900,42669,46962182,165745
115,m_3807664_ne_18_1_20170611,0.008845919281152527,0.034531754691663315,0.008914977258313202,0.5331369951068491,762290,46402646,406405,1222283,45180363,355885
116,m_3907542_ne_18_1_20170609,0.018736819609903983,0.018776641774302105,0.018753792229110205,0.953923706743523,906974,45270506,865184,1874,45268632,41790
117,m_3907633_ne_18_1_20170609,0.009791700049635189,0.012085458464492724,0.00987319773759017,0.5425925816914591,849385,46327311,460870,109282,46218029,388515
118,m_3907526_sw_18_1_20170609,0.015824000417696923,0.016085469855730818,0.015840538343364064,0.9381062438781098,777946,45353874,729796,12256,45341618,48150
119,m_3807563_nw_18_1_20170611,0.002798679501790312,0.0029696540038321234,0.002798954687597076,0.9660623208369011,134305,46233723,129747,7950,46225773,4558
120,m_3907622_nw_18_1_20170611,0.009512105951766622,0.010223747576189796,0.00953682792683205,0.7858406544656684,562413,45934627,441967,33407,45901220,120446
121,m_3807732_nw_18_1_20170716,0.004552453814795268,0.004896772690298863,0.004557590562849784,0.801554789029691,271934,47624306,217970,16567,47607739,53964
122,m_3907651_sw_18_1_20170716,0.043852811261749225,0.05799642130914451,0.045809323586840506,0.506601548514754,4024889,43170023,2039015,698121,42471902,1985874
123,m_3807609_ne_18_1_20170716,0.0373324144939632,0.04493516730120746,0.03803867294712517,0.6678515854182556,2636749,44908395,1760957,375492,44532903,875792
124,m_3907658_nw_18_1_20170716,0.03382503853522565,0.0437918472484305,0.034610353013934475,0.5985122387067282,2646930,44676970,1584220,488181,44188789,1062710
125,m_3807638_ne_18_1_20170730,0.0009979786102229926,0.00106762628600439,0.0009980527693275595,0.9307050166165532,50552,47097032,47049,3287,47093745,3503
126,m_3807555_nw_18_1_20170611,0.0013211561642724858,0.0013434699584116464,0.0013212272434648226,0.9608729784895588,63690,46258894,61198,1035,46257859,2492
127,m_3807613_se_18_1_20170730,0.002548731021421929,0.0030941888878420615,0.0025489583558915762,0.9661903074047818,124136,46959932,119939,25748,46934184,4197
128,m_3807602_se_18_1_20170716,0.013147483525721775,0.014724626359827518,0.01318167613084034,0.8352151497177946,745202,46670738,622404,75778,46594960,122798
129,m_3807620_ne_18_1_20170730,0.0035438919492866918,0.004328722011110239,0.003545419238176802,0.891619159251958,187690,47071062,167348,37222,47033840,20342
130,m_3907541_ne_18_1_20170609,0.02335069136264217,0.023688476376419777,0.02338038122740924,0.9484226747733154,1140792,45210184,1081953,16031,45194153,58839
131,m_3907646_sw_18_1_20170611,0.0024469581083778427,0.0030590092419163196,0.0024483412572081408,0.812432455491724,140648,46585592,114267,28669,46556923,26381
132,m_3807652_se_18_1_20170730,0.003253843412388884,0.0036099518504949207,0.0032559285478493036,0.8355495807756056,185223,47394913,154763,16999,47377914,30460
133,m_3807604_se_18_1_20170611,0.010670342286794312,0.015234051829442726,0.010720448368779414,0.6953980825343893,719700,46401316,500478,217366,46183950,219222
134,m_3807656_ne_18_1_20170611,0.0031049687937246408,0.005960448381627767,0.003106895866472483,0.833498229982214,174857,46898615,145743,134836,46763779,29114
135,m_3807708_se_18_1_20170725,0.048422437190565125,0.08416501499105576,0.05065255045793009,0.523768375438724,4237858,43390542,2219656,1788989,41601553,2018202
136,m_3907663_sw_18_1_20170611,0.0006554089386235822,0.0006810007585961116,0.0006554974126452421,0.8292313517606967,36974,46744178,30660,1198,46742980,6314
137,m_3807642_sw_18_1_20170626,0.005405000658700859,0.00969017012710819,0.00541374774515686,0.769864365719071,334355,47495765,257408,206074,47289691,76947
138,m_3807623_sw_18_1_20170730,0.00022089929179141936,0.00025902616213210834,0.00022091083064431432,0.8087627660403836,12827,46951541,10374,1791,46949750,2453
139,m_3807625_sw_18_1_20170716,0.013777401018508998,0.015254130329150807,0.013825649905163195,0.7978938388832922,822919,46906449,656602,71468,46834981,166317
140,m_3807518_sw_18_1_20170611,0.009463641331104366,0.01062448321056189,0.00951760567371599,0.6253401124108756,704914,45929166,440811,54652,45874514,264103
141,m_3807747_nw_18_1_20170731,0.0011565989742315808,0.001274131267712085,0.0011568867495043622,0.8229978555054351,67615,48050661,55647,5662,48044999,11968
142,m_3907624_sw_18_1_20170611,0.008120009217681369,0.00885847403091292,0.00814064674681835,0.7620750398835623,493311,45839161,375940,34495,45804666,117371
143,m_3907641_nw_18_1_20170609,0.013080788544767642,0.014553856483066934,0.013151751446049399,0.7079694135692945,873590,46478258,618475,70677,46407581,255115
144,m_3807604_nw_18_1_20170611,0.009867171005230073,0.012502957082710356,0.009901950680678163,0.7374800166541126,629274,46528690,464077,125537,46403153,165197
145,m_3807661_nw_18_1_20170730,0.0005286931299580772,0.000580921487340914,0.000528710161973548,0.9425675675675675,26640,47470312,25110,2482,47467830,1530
146,m_3907541_se_18_1_20170609,0.01630780310142703,0.016395938915618774,0.016324376424291378,0.9413931264465072,803660,45593012,756560,4157,45588855,47100
147,m_3907635_sw_18_1_20170609,0.014463934628578284,0.01961699183287658,0.014632408787493346,0.5567826716226439,1216040,45840920,677070,246046,45594874,538970
148,m_3807535_ne_18_1_20170611,0.013230625354516608,0.013394194878822721,0.013272444559390905,0.8076587687171438,762603,45797941,615923,7718,45790223,146680
149,m_3807553_ne_18_1_20170611,0.005261189321022259,0.005346396997629961,0.005267390113264094,0.8171587431000147,299276,46187732,244556,3982,46183750,54720
150,m_3807537_nw_18_1_20170611,0.013648432176271366,0.013771660610011846,0.013690004767327993,0.8179990937714212,774639,45658033,633654,5801,45652232,140985
151,m_3807619_se_18_1_20170626,0.006376707645499195,0.006980207355055649,0.006389339019478478,0.7633436125575047,395620,46992084,301994,28782,46963302,93626
152,m_3807643_sw_18_1_20170626,0.004285979383434283,0.004648119876901258,0.0042919862371727634,0.7538398487690331,270844,47383908,204173,17332,47366576,66671
153,m_3807549_ne_18_1_20170611,0.003656941194337874,0.01881467234381597,0.003661804679760761,0.733573193463089,230690,46760030,169228,714887,46045143,61462
154,m_3807707_nw_18_1_20170730,0.007682138539365037,0.008824170509751792,0.007697262573917865,0.796324309286596,460104,47288860,366392,54953,47233907,93712
155,m_3907542_se_18_1_20170609,0.015894953660476538,0.01592898454249948,0.015912155097982602,0.9363203133056882,785431,45483369,735415,1600,45481769,50016
156,m_3907626_se_18_1_20170609,0.003029031061499444,0.0032961810312835166,0.003033136146449609,0.6911739735796516,206129,46841651,142471,12607,46829044,63658
157,m_3907557_nw_18_1_20170709,0.02082255611307131,0.021114561560750363,0.02087039977885806,0.9008254402487379,1076153,45494267,969426,13888,45480379,106727
158,m_3807647_ne_18_1_20170709,0.0010455513638004592,0.001090554290120147,0.0010456307861636148,0.9322729507886673,52874,47094710,49293,2124,47092586,3581
159,m_3907657_nw_18_1_20170716,0.019499806122224836,0.023416531824595785,0.019633542987203115,0.7411146099411591,1244543,46245581,922349,189705,46055876,322194
160,m_3807648_sw_18_1_20170611,0.004849762058927903,0.005252708295146652,0.004852667236476879,0.8901196295544346,256124,46771616,227981,19042,46752574,28143
161,m_3807539_se_18_1_20170611,0.006240988828212006,0.006763841227533098,0.006252539901568565,0.7715965165741487,373081,45776583,287868,24281,45752302,85213
162,m_3907660_se_18_1_20170611,0.009077637674902517,0.014468390765530756,0.009107356647408629,0.7355781129658956,577785,46497319,425006,256095,46241224,152779
163,m_3807606_nw_18_1_20170611,0.009293834203546085,0.011582364045571716,0.00933407353390282,0.6831265905803128,637346,46318094,435388,108467,46209627,201958
164,m_3807636_ne_18_1_20170730,0.005571547526652017,0.0059096572724966455,0.0055772121545035365,0.8458115057432595,312105,47084383,263982,16115,47068268,48123
165,m_3907550_sw_18_1_20170609,0.03421537579738784,0.034368763497592325,0.034302098332608354,0.9311934362240674,1703166,44656954,1585977,7363,44649591,117189
166,m_3907640_sw_18_1_20170611,5.993171872763993e-05,6.47948034008169e-05,5.9932077266026464e-05,0.9092393078681031,3063,46466713,2785,226,46466487,278
167,m_3807526_sw_18_1_20170611,0.004317090508702484,0.0044690254123025165,0.004325140363282454,0.6987541487953769,288638,46436762,201687,7130,46429632,86951
168,m_3807624_nw_18_1_20170611,0.009342559357437288,0.009772195062600988,0.009358100223895015,0.8490730702620305,515627,46366061,437805,20332,46345729,77822
169,m_3807612_se_18_1_20170730,0.0033890780120190717,0.004398083233289927,0.003391501785022715,0.8258513172102732,193553,47019287,159846,47800,46971487,33707
170,m_3907634_se_18_1_20170609,0.037020539461911306,0.04863442092306856,0.0380789842488964,0.5711585292600835,3013286,44043674,1721064,567524,43476150,1292222
171,m_3807628_ne_18_1_20170730,0.002363161582107888,0.0025687755097213603,0.0023640398172314107,0.8641521384818595,129461,47221115,111874,9759,47211356,17587
172,m_3907549_nw_18_1_20170709,0.0028768889020229418,0.00300547728497164,0.0028797222758115315,0.745154703591712,179246,46253978,133566,5988,46247990,45680
173,m_3807545_sw_18_1_20170611,0.0024409782310235986,0.0024829517959082245,0.002442174703530464,0.8328427882533415,136243,46350765,113469,1956,46348809,22774
174,m_3907661_ne_18_1_20170611,0.0019005748343239955,0.11668377804582478,0.0019717502849886134,0.050017531212215166,1577187,45323377,78887,5393648,39929729,1498300
175,m_3807509_ne_18_1_20170709,0.006691323383433062,0.007264319481467857,0.006710101426680966,0.7051070989217744,442208,46182944,311804,26896,46156048,130404
176,m_3907551_sw_18_1_20170609,0.029268238653667424,0.029399216824939782,0.02933001456207791,0.9328678725163223,1450319,44782001,1352956,6238,44775763,97363
177,m_3907645_nw_18_1_20170611,0.061482586055959666,0.07393610371991838,0.06321056270109121,0.6922200817764493,4105583,42739961,2841967,621610,42118351,1263616
178,m_3807563_ne_18_1_20170611,0.001155405193330909,0.0012938554535577853,0.001155561546908385,0.8951699223976451,59792,46271504,53524,6422,46265082,6268
179,m_3907619_ne_18_1_20170611,0.012890590261786057,0.013616602387071873,0.012932411524873047,0.7994450288030582,753913,46036467,602712,34414,46002053,151201
180,m_3907558_nw_18_1_20170609,0.04763353672514894,0.04770447099791804,0.04767707552482564,0.9811892208943485,2250465,44109655,2208132,3453,44106202,42333
181,m_3807643_se_18_1_20170626,0.01089756856416007,0.013197012422590344,0.010967509873731105,0.630839623963493,820665,46796779,517708,110700,46686079,302957
182,m_3807620_nw_18_1_20170626,0.008134790078221724,0.0088913220057963,0.008156930414629254,0.7498132876773768,512821,46791843,384520,36081,46755762,128301
183,m_3907654_nw_18_1_20170611,0.0021261381881530774,0.0228164109870675,0.002127553590833836,0.7616716072364356,127853,46644227,97382,969789,45674438,30471
184,m_3807731_nw_18_1_20170731,0.0024092423290121554,0.003608186314469444,0.0024129713931975508,0.6092150530825894,189516,47790268,115456,57664,47732604,74060
185,m_3807739_ne_18_1_20170731,0.0010032821844617927,0.001086343693705258,0.0010034872965745403,0.8307506471095772,57950,47930546,48142,3990,47926556,9808
186,m_3907619_sw_18_1_20170609,0.002622550669374807,0.002983055396226621,0.002625007602732929,0.7369773879282453,166902,46752106,123003,16959,46735147,43899
187,m_3907617_ne_18_1_20170609,0.009311094884635655,0.010410848740844952,0.009360499851984398,0.6382217657759643,685489,46353039,437494,52217,46300822,247995
188,m_3907643_sw_18_1_20170609,0.04373883667691104,0.0579689956047357,0.0449125862511688,0.6259768799556543,3245409,43903519,2031551,701625,43201894,1213858
189,m_3907636_nw_18_1_20170611,0.019924918024590583,0.02171729320078254,0.01999219702599332,0.8555072192768257,1090968,45837256,933331,85823,45751433,157637
190,m_3807607_se_18_1_20170611,0.0032713902266775603,0.0035980792901239215,0.0032736464469118338,0.825984060516007,185075,46559309,152869,15321,46543988,32206
191,m_3807724_sw_18_1_20170716,0.0029459880657978933,0.0031501075692362017,0.002947125387484977,0.8841774415146896,159399,47690713,140937,9796,47680917,18462
192,m_3807647_se_18_1_20170709,0.0014558333569971505,0.0015533320048986524,0.0014560866281994207,0.8932736942020882,76907,47116481,68699,4608,47111873,8208
193,m_3907549_se_18_1_20170709,0.017213880508516997,0.01736618091918317,0.017250856658198827,0.8892698691279054,897976,45498696,798543,7190,45491506,99433
194,m_3807533_se_18_1_20170611,0.0026252911918876074,0.006784618744992302,0.0026357098057054637,0.3990920535114439,306626,46501310,122372,195202,46306108,184254
195,m_3807501_se_18_1_20170709,0.011227199599560716,0.011536996052508642,0.011248287937306178,0.8569070617102639,610093,45969363,522793,14594,45954769,87300
196,m_3807538_ne_18_1_20170611,0.005758106362853532,0.005791349242851264,0.005764301020324706,0.8427197671843861,316130,45952190,266409,1547,45950643,49721
197,m_3907718_nw_18_1_20170710,0.008755809569092896,0.009872097235951187,0.008813449334944453,0.5724327340647166,732949,47239431,419564,54024,47185407,313385
198,m_3807541_nw_18_1_20170611,0.003321602073999282,0.0066049598781758,0.0033241245237634835,0.8140316878355375,190925,46754099,155419,154651,46599448,35506
199,m_3807562_ne_18_1_20170611,0.0007969229478179193,0.000804000151560035,0.0007969573483032798,0.9486187278970837,39022,46411218,37017,329,46410889,2005
200,m_3807634_sw_18_1_20170626,0.00491924924666488,0.0057222871133485054,0.004927199879485755,0.7529996951366269,311615,47426465,234646,38525,47387940,76969
201,m_3907717_nw_18_1_20170628,0.00021928188671996613,0.0002360003652698198,0.0002192904690267066,0.8485530546623794,12440,48127316,10556,805,48126511,1884
202,m_3907644_ne_18_1_20170611,0.051685730056252106,0.05841345596093241,0.05241665747649394,0.7875285494132704,3055667,43835789,2406425,332667,43503122,649242
203,m_3907639_ne_18_1_20170611,0.007662240505548394,0.010470396930684581,0.007721562443823461,0.4993354944413583,711055,45758721,355055,131502,45627219,356000
204,m_3807642_se_18_1_20170626,0.0052514057044934686,0.005616564386334766,0.0052616156779854255,0.7301864801864801,343200,47394880,250600,17524,47377356,92600
205,m_3907526_se_18_1_20170609,0.02783714553197403,0.02793728095376139,0.027860082237494022,0.9712746069736574,1320713,44765447,1282775,4747,44760700,37938
206,m_3807541_sw_18_1_20170611,0.0041778573560131305,0.008816610680612284,0.004182321503368218,0.7965041555993488,245091,46699933,195216,218680,46481253,49875
207,m_3907648_se_18_1_20170611,0.005942420772642462,0.006341429145647952,0.005958134135709366,0.6926127003897304,398224,46035000,275815,18638,46016362,122409
208,m_3807502_ne_18_1_20170609,0.032615785562920455,0.032742343402056,0.03268713367413557,0.9372744366368422,1616231,44835209,1514852,6077,44829132,101379
209,m_3807617_sw_18_1_20170716,0.007878129160435949,0.00859197867799116,0.007887326157246622,0.8710720136629647,430946,47252366,375385,34309,47218057,55561
210,m_3907655_nw_18_1_20170611,0.0038864991014231553,0.004127326666544441,0.003888799477237656,0.8679022327259158,209027,46480517,181415,11288,46469229,27612
211,m_3907518_ne_18_1_20170609,0.018142652387344745,0.018274897792882855,0.01816506215395789,0.9363308573422916,891091,45103749,834356,6195,45097554,56735
212,m_3807622_ne_18_1_20170730,0.00045897449894150173,0.0005250905900297404,0.0004590150496221799,0.8385894050023303,25748,47021372,21592,3112,47018260,4156
213,m_3907622_sw_18_1_20170611,0.004613300451534449,0.004864976125241927,0.004618064695673964,0.8172431909725659,262666,46280214,214662,11768,46268446,48004
214,m_3907647_se_18_1_20170611,0.00391575105528392,0.004273633870110876,0.003919199257382735,0.8165343536073976,223208,46338104,182257,16729,46321375,40951
215,m_3907655_ne_18_1_20170611,0.00553638526956679,0.005658753991882778,0.00554369690924442,0.8076070692968892,319466,46287614,258003,5735,46281879,61463
216,m_3907660_sw_18_1_20170626,0.0058086081513191515,0.006495064121088858,0.0058165124927748585,0.8104028137156797,337774,46820190,273733,32561,46787629,64041
217,m_3807732_sw_18_1_20170716,0.0016649980702634574,0.0017419530217820855,0.0016653695854447104,0.8818468343931435,90425,47805815,79741,3692,47802123,10684
218,m_3807555_ne_18_1_20170611,0.0046260619389029934,0.005048777863109086,0.004628867629376245,0.8841538995488125,242028,46035112,213990,19653,46015459,28038
219,m_3907541_sw_18_1_20170709,0.008130437839526907,0.008271453865192797,0.008142904072048021,0.8415408957315618,448103,45939389,377097,6595,45932794,71006
220,m_3807655_ne_18_1_20170709,0.0003724885254594064,0.00038540687542815925,0.00037249535959170676,0.9530572419774501,18448,47183616,17582,610,47183006,866
221,m_3907647_ne_18_1_20170611,0.0010481337585263831,0.0011194272188893646,0.0010482988682264758,0.8693615050238723,56132,46505180,48799,3323,46501857,7333
222,m_3807533_ne_18_1_20170611,0.0038902244188786764,0.004355129004987272,0.0038924279440134173,0.8729659674554793,208330,46562730,181865,21829,46540901,26465
223,m_3807502_se_18_1_20170609,0.03345395021544829,0.03353926164614057,0.03348561594073988,0.9725098105484519,1597770,44853670,1553847,4100,44849570,43923
224,m_3907636_sw_18_1_20170611,0.04379301865970758,0.05083946922858193,0.04446746307645761,0.7427560689836469,2746506,44181718,2039984,345822,43835896,706522
225,m_3807650_ne_18_1_20170626,0.0022252276254883666,0.002486822111255418,0.002227064278029212,0.7296009325287987,145840,47684280,106405,12540,47671740,39435
226,m_3807651_nw_18_1_20170626,0.0010737668045605621,0.0011608835553396913,0.0010741201861945344,0.7654654968837341,66907,47633829,51215,4160,47629669,15692
227,m_3907660_ne_18_1_20170611,0.01939261297222035,0.022613226728081155,0.019490335286048967,0.7945675950627202,1145165,45929939,909911,154609,45775330,235254
228,m_3807554_sw_18_1_20170611,0.006217573294729274,0.0063475452441149926,0.0062208890634327324,0.9210429790287856,313525,46136715,288770,6075,46130640,24755
229,m_3807632_se_18_1_20170611,0.018598104474115116,0.02001407789169603,0.01873923639317628,0.711767557012629,1223457,45667087,870817,67654,45599433,352640
230,m_3807537_ne_18_1_20170611,0.01883788972859023,0.018980437303103358,0.018980121482882622,0.7154096721721209,1220305,45130155,873018,6734,45123421,347287
231,m_3807716_se_18_1_20170716,0.01563936450740211,0.020326406734670305,0.015789536674291185,0.6218378208224743,1194469,46526115,742766,227222,46298893,451703
232,m_3907623_se_18_1_20170611,0.004879106153718592,0.005267316058353902,0.004885773193669063,0.7814461175203496,289686,46125034,226374,18107,46106927,63312
233,m_3907639_se_18_1_20170611,2.429295828617436e-06,2.5797827926079936e-06,2.429299693308438e-06,0.6042780748663101,187,46515357,113,7,46515350,74
234,m_3807525_nw_18_1_20170611,0.010493496479234737,0.010766998061599649,0.010512943640691661,0.850135193344647,578061,46266751,491430,12948,46253803,86631
235,m_3807552_se_18_1_20170611,0.002647971315274503,0.00267112132434965,0.0026514505130451056,0.668652964820854,184598,46430282,123432,1082,46429200,61166
236,m_3907639_sw_18_1_20170611,0.0004896580763322344,0.0005359035644840578,0.0004897353059660818,0.7563983556557485,30164,46567772,22816,2156,46565616,7348
237,m_3907525_nw_18_1_20170709,0.03029872206122993,0.03184660699252606,0.030547464116247036,0.7881768514794146,1775094,44475202,1399088,73827,44401375,376006
238,m_3807517_ne_18_1_20170611,0.012786123995193436,0.013342397378337758,0.0128454133995726,0.7347615363387278,811696,45859152,596403,26298,45832854,215293
239,m_3807611_ne_18_1_20170626,0.004657126055124669,0.004953293112150659,0.00466226165159418,0.8087182632520319,272279,47023529,220197,14073,47009456,52082
240,m_3807631_sw_18_1_20170730,0.001095031207508191,0.0012677652521836755,0.0010951815071841647,0.8886304108078301,58032,47043748,51569,8145,47035603,6463
241,m_3907618_se_18_1_20170609,0.0025794354411997015,0.0027960159929329193,0.002581437165945972,0.7688639711484736,157496,46798244,121093,10196,46788048,36403
242,m_3907651_ne_18_1_20170716,0.05869082535319691,0.08284501267452382,0.0615124142922801,0.5613067119750023,4794997,42271071,2691464,1207725,41063346,2103533
243,m_3807602_sw_18_1_20170716,0.033483974318623544,0.04726578927629622,0.034526519000964595,0.5258207169241975,2979255,44482705,1566554,676773,43805932,1412701
244,m_3907635_ne_18_1_20170611,0.04173915882602311,0.058864291938982974,0.04309958698655277,0.5693987299748935,3381193,43583799,1925247,839314,42744485,1455946
245,m_3807547_ne_18_1_20170611,0.004988279827702442,0.005608253182515045,0.004996802935739009,0.7451875892761707,308733,45840931,230064,28755,45812176,78669
246,m_3807527_sw_18_1_20170611,0.007169243937705788,0.008389217815825942,0.007182026819512661,0.8011145498942354,416491,46180821,333657,57258,46123563,82834
247,m_3807653_nw_18_1_20170730,0.005345686106181392,0.005798814762388107,0.00535126037111018,0.8369164446821082,302949,47148127,253543,21617,47126510,49406
248,m_3807606_sw_18_1_20170611,0.005956539558475616,0.006599597405540231,0.00596570862081617,0.7948941083459174,351633,46603807,279511,30376,46573431,72122
249,m_3907622_se_18_1_20170611,0.00562524628973678,0.006265086981880997,0.005633573146717285,0.7919174965386235,330071,46166969,261389,29919,46137050,68682
250,m_3807664_se_18_1_20170611,0.012213380651437683,0.060779876813571845,0.012349425977758809,0.5257655561411037,1041759,46123177,547721,2318958,43804219,494038
251,m_3807554_se_18_1_20170611,0.0031273582416159605,0.0031775619570061347,0.0031285698923423735,0.8898079564406945,163088,46241672,145117,2337,46239335,17971
252,m_3807626_se_18_1_20170626,0.011181006630667716,0.012692318431149867,0.011222074288695922,0.7534092247356973,704779,46858005,530987,72695,46785310,173792
253,m_3807740_se_18_1_20170716,0.00026229666711221266,0.00028690144601334745,0.0002623087630291153,0.8504805739813185,14774,47890178,12565,1179,47888999,2209
254,m_3807633_sw_18_1_20170716,0.0016215262165019235,0.0016918146779061282,0.0016219107853148959,0.8724286774128279,88962,47778574,77613,3370,47775204,11349
255,m_3807510_sw_18_1_20170611,0.011483744946936256,0.011638085172238079,0.011528599947715415,0.7469343528419548,716162,45872258,534926,7274,45864984,181236
256,m_3907559_nw_18_1_20170609,0.027401693581022124,0.027531344089097822,0.027478927963673655,0.9069693414784189,1397980,44879964,1267925,6169,44873795,130055
257,m_3807624_ne_18_1_20170611,0.0076735146665754695,0.007973126822151205,0.007682406135464998,0.8689395938066528,413153,46385927,359005,14130,46371797,54148
258,m_3907651_nw_18_1_20170716,0.03017741814242672,0.04116770162833819,0.03108442860846044,0.5084109359515467,2766874,44382054,1406709,534304,43847750,1360165
259,m_3807503_sw_18_1_20170609,0.05107486191876547,0.05117346017157254,0.05115010151810817,0.9720062029657006,2436254,43932938,2368054,4818,43928120,68200
260,m_3807626_sw_18_1_20170626,0.006125676696132448,0.006518900480727086,0.006134410202441057,0.8114158319081358,360184,47369184,292259,18884,47350300,67925
261,m_3807640_ne_18_1_20170611,0.004738865704736718,0.004840477757545145,0.0047435694019233934,0.8269607606185789,268939,46667337,222402,4792,46662545,46537
262,m_3807641_ne_18_1_20170626,0.0017422074579034668,0.001777423032495021,0.0017425661394751511,0.894337394664806,93155,47728325,83312,1687,47726638,9843
263,m_3907624_nw_18_1_20170611,0.005342455818994517,0.005868056623776884,0.00535198306656932,0.7500720773762014,329507,45957197,247154,24459,45932738,82353
264,m_3907634_nw_18_1_20170609,0.017194057341659033,0.021608931664057186,0.017387954426016736,0.6065931506952217,1331230,45845466,807515,211923,45633543,523715
265,m_3807546_nw_18_1_20170611,0.02301130549829616,0.023107561892999496,0.023064343904242054,0.90914644134429,1172128,45141672,1065636,4563,45137109,106492
266,m_3907517_sw_18_1_20170709,0.022969099394706965,0.023765639255896885,0.023039194257839124,0.8830357298993814,1200871,45003693,1060412,37669,44966024,140459
267,m_3807603_sw_18_1_20170716,0.009993186054390436,0.013687593465715492,0.010087445966379832,0.5167784866901639,911882,46420982,471241,176632,46244350,440641
268,m_3907664_ne_18_1_20170611,0.016025714563396628,0.016487504299939747,0.01605789343576072,0.8888536724281326,839254,45731166,745974,21856,45709310,93280
269,m_3807636_se_18_1_20170730,0.006809117328145949,0.007156130381262331,0.006815464473941889,0.8796850951388605,367095,47075305,322928,16576,47058729,44167
270,m_3807633_nw_18_1_20170716,0.0018708881978821111,0.002000774547337305,0.0018717770865961326,0.7975553653578689,112164,47709316,89457,6223,47703093,22707
271,m_3907638_sw_18_1_20170611,0.0201020887302178,0.02592181528546531,0.020281547461912176,0.6943615521016804,1344448,45372612,933533,277458,45095154,410915
272,m_3807614_se_18_1_20170730,0.0014787727511951067,0.0016973154773657227,0.0014792724633651273,0.814041212234809,85363,46915917,69489,10287,46905630,15874
